13 12 12 12 12 12 12 12 12 12 12 12 12 12 12 12 12 12 12 13 11 12 12 12 12 12 12 12 12 12 12 12 12 12 12 12 12 12 12 13 11 12 12 12 12 12 12 12 12 12 12 12 12 12 12 12 12 12 13
14 10 10 10 10 10 10 10 10 10 10 10 10 10 10 10 10 10 10 15 14 10 10 10 10 10 10 10 10 10 10 10 10 10 10 10 10 10 10 15 14 10 10 10 10 10 10 10 10 10 10 10 10 10 10 10 10 10 15
14 10 10 10 10 10 10 10 10 10 10 10 10 10 10 10 10 10 10 15 14 10 10 10 10 10 10 10 10 10 10 10 10 10 10 10 10 10 10 15 14 10 10 10 10 10 10 10 10 10 10 10 10 10 10 10 10 10 15
14 10 10 10 10 10 10 10 10 10 10 10 10 10 10 10 10 10 10 15 14 10 10 10 10 10 10 10 10 10 10 10 10 10 10 10 10 10 10 15 14 10 10 10 10 10 10 10 10 10 10 10 10 10 10 10 10 10 15
14 10 10 10 10 10 10 10 10 10 10 10 10 10 10 10 10 10 10 15 14 10 10 10 10 10 10 10 10 10 10 10 10 10 10 10 10 10 10 15 14 10 10 10 10 10 10 10 10 10 10 10 10 10 10 10 10 10 15
14 10 10 10 10 10 10 10 10 10 10 10 10 10 10 10 10 10 10 15 14 10 10 10 10 10 10 10 10 10 10 10 10 10 10 10 10 10 10 15 14 10 10 10 10 10 10 10 10 10 10 10 10 10 10 10 10 10 15
14 10 10 10 10 10 10 10 10 10 10 10 10 10 10 10 10 10 10 10 10 10 10 10 10 10 10 10 10 10 10 10 10 10 10 10 10 10 10 15 14 10 10 10 10 10 10 10 10 10 10 10 10 10 10 10 10 10 15
14 10 10 10 10 10 10 10 10 10 10 10 10 10 10 10 10 10 10 15 14 10 10 10 10 10 10 10 10 10 10 10 10 10 10 10 10 10 10 15 14 10 10 10 10 10 10 10 10 10 10 10 10 10 10 10 10 10 15
14 10 10 10 10 10 10 10 10 10 10 10 10 10 10 10 10 10 10 15 14 10 10 10 10 10 10 10 10 10 10 10 10 10 10 10 10 10 10 15 14 10 10 10 10 10 10 10 10 10 10 10 10 10 10 10 10 10 15
14 10 10 10 10 10 10 10 10 10 10 10 10 10 10 10 10 10 10 15 14 10 10 10 10 10 10 10 10 10 10 10 10 10 10 10 10 10 10 15 14 10 10 10 10 10 10 10 10 10 10 10 10 10 10 10 10 10 15
14 10 10 10 10 10 10 10 10 10 10 10 10 10 10 10 10 10 10 15 14 10 10 10 10 10 10 10 10 10 10 10 10 10 10 10 10 10 10 15 14 10 10 10 10 10 10 10 10 10 10 10 10 10 10 10 10 10 15
14 10 10 10 10 10 10 10 10 10 10 10 10 10 10 10 10 10 10 15 14 10 10 10 10 10 10 10 10 10 10 10 10 10 10 10 10 10 10 15 14 10 10 10 10 10 10 10 10 10 10 10 10 10 10 10 10 10 15
16 17 17 17 17 17 17 17 17 10 17 17 17 17 17 17 17 17 17 18 16 17 17 17 17 17 17 17 17 17 17 17 17 17 17 17 17 17 17 18 16 17 17 17 17 17 17 17 17 10 10 17 17 17 17 17 17 17 18
11 12 12 12 12 12 12 12 12 10 12 12 12 12 12 12 12 12 12 13 11 12 12 12 12 12 12 12 12 12 12 12 12 12 12 12 12 12 12 13 11 12 12 12 12 12 12 12 12 10 10 12 12 12 12 12 12 12 13
14 10 10 10 10 10 10 10 10 10 10 10 10 10 10 10 10 10 10 15 14 10 10 10 10 10 10 10 10 10 10 10 10 10 10 10 10 10 10 15 14 10 10 10 10 10 10 10 10 10 10 10 10 10 10 10 10 10 15
14 10 10 10 10 10 10 10 10 10 10 10 10 10 10 10 10 10 10 15 14 10 10 10 10 10 10 10 10 10 10 10 10 10 10 10 10 10 10 15 14 10 10 10 10 10 10 10 10 10 10 10 10 10 10 10 10 10 15
14 10 10 10 10 10 10 10 10 10 10 10 10 10 10 10 10 10 10 15 14 10 10 10 10 10 10 10 10 10 10 10 10 10 10 10 10 10 10 15 14 10 10 10 10 10 10 10 10 10 10 10 10 10 10 10 10 10 15
14 10 10 10 10 10 10 10 10 10 10 10 10 10 10 10 10 10 10 15 14 10 10 10 10 10 10 10 10 10 10 10 10 10 10 10 10 10 10 15 14 10 10 10 10 10 10 10 10 10 10 10 10 10 10 10 10 10 15
14 10 10 10 10 10 10 10 10 10 10 10 10 10 10 10 10 10 10 10 10 10 10 10 10 10 10 10 10 10 10 10 10 10 10 10 10 10 10 10 10 10 10 10 10 10 10 10 10 10 10 10 10 10 10 10 10 10 15
14 10 10 10 10 10 10 10 10 10 10 10 10 10 10 10 10 10 10 10 10 10 10 10 10 10 10 10 10 10 10 10 10 10 10 10 10 10 10 10 10 10 10 10 10 10 10 10 10 10 10 10 10 10 10 10 10 10 15
14 10 10 10 10 10 10 10 10 10 10 10 10 10 10 10 10 10 10 15 14 10 10 10 10 10 10 10 10 10 10 10 10 10 10 10 10 10 10 15 14 10 10 10 10 10 10 10 10 10 10 10 10 10 10 10 10 10 15
14 10 10 10 10 10 10 10 10 10 10 10 10 10 10 10 10 10 10 15 14 10 10 10 10 10 10 10 10 10 10 10 10 10 10 10 10 10 10 15 14 10 10 10 10 10 10 10 10 10 10 10 10 10 10 10 10 10 15
14 10 10 10 10 10 10 10 10 10 10 10 10 10 10 10 10 10 10 15 14 10 10 10 10 10 10 10 10 10 10 10 10 10 10 10 10 10 10 15 14 10 10 10 10 10 10 10 10 10 10 10 10 10 10 10 10 10 15
14 10 10 10 10 10 10 10 10 10 10 10 10 10 10 10 10 10 10 15 14 10 10 10 10 10 10 10 10 10 10 10 10 10 10 10 10 10 10 15 14 10 10 10 10 10 10 10 10 10 10 10 10 10 10 10 10 10 15
16 17 17 17 17 17 17 17 17 10 10 17 17 17 17 17 17 17 17 18 16 17 17 17 17 17 17 17 17 10 10 17 17 17 17 17 17 17 17 18 16 17 17 17 17 17 17 17 17 10 10 17 17 17 17 17 17 17 18
11 12 12 12 12 12 12 12 12 10 10 12 12 12 12 12 12 12 12 13 11 12 12 12 12 12 12 12 12 10 10 12 12 12 12 12 12 12 12 13 11 12 12 12 12 12 12 12 12 10 10 12 12 12 12 12 12 12 13
14 10 10 10 10 10 10 10 10 10 10 10 10 10 10 10 10 10 10 15 14 10 10 10 10 10 10 10 10 10 10 10 10 10 10 10 10 10 10 15 14 10 10 10 10 10 10 10 10 10 10 10 10 10 10 10 10 10 15
14 10 10 10 10 10 10 10 10 10 10 10 10 10 10 10 10 10 10 15 14 10 10 10 10 10 10 10 10 10 10 10 10 10 10 10 10 10 10 15 14 10 10 10 10 10 10 10 10 10 10 10 10 10 10 10 10 10 15
14 10 10 10 10 10 10 10 10 10 10 10 10 10 10 10 10 10 10 15 14 10 10 10 10 10 10 10 10 10 10 10 10 10 10 10 10 10 10 15 14 10 10 10 10 10 10 10 10 10 10 10 10 10 10 10 10 10 15
14 10 10 10 10 10 10 10 10 10 10 10 10 10 10 10 10 10 10 15 14 10 10 10 10 10 10 10 10 10 10 10 10 10 10 10 10 10 10 15 14 10 10 10 10 10 10 10 10 10 10 10 10 10 10 10 10 10 15
14 10 10 10 10 10 10 10 10 10 10 10 10 10 10 10 10 10 10 10 10 10 10 10 10 10 10 10 10 10 10 10 10 10 10 10 10 10 10 10 10 10 10 10 10 10 10 10 10 10 10 10 10 10 10 10 10 10 15
14 10 10 10 10 10 10 10 10 10 10 10 10 10 10 10 10 10 10 10 10 10 10 10 10 10 10 10 10 10 10 10 10 10 10 10 10 10 10 10 10 10 10 10 10 10 10 10 10 10 10 10 10 10 10 10 10 10 15
14 10 10 10 10 10 10 10 10 10 10 10 10 10 10 10 10 10 10 15 14 10 10 10 10 10 10 10 10 10 10 10 10 10 10 10 10 10 10 15 14 10 10 10 10 10 10 10 10 10 10 10 10 10 10 10 10 10 15
14 10 10 10 10 10 10 10 10 10 10 10 10 10 10 10 10 10 10 15 14 10 10 10 10 10 10 10 10 10 10 10 10 10 10 10 10 10 10 15 14 10 10 10 10 10 10 10 10 10 10 10 10 10 10 10 10 10 15
14 10 10 10 10 10 10 10 10 10 10 10 10 10 10 10 10 10 10 15 14 10 10 10 10 10 10 10 10 10 10 10 10 10 10 10 10 10 10 15 14 10 10 10 10 10 10 10 10 10 10 10 10 10 10 10 10 10 15
14 10 10 10 10 10 10 10 10 10 10 10 10 10 10 10 10 10 10 15 14 10 10 10 10 10 10 10 10 10 10 10 10 10 10 10 10 10 10 15 14 10 10 10 10 10 10 10 10 10 10 10 10 10 10 10 10 10 15
16 17 17 17 17 17 17 17 17 17 17 17 17 17 17 17 17 17 17 18 16 17 17 17 17 17 17 17 17 17 17 17 17 17 17 17 17 17 17 18 16 17 17 17 17 17 17 17 17 17 17 17 17 17 17 17 17 17 18